0=⑦
1=9
2=5
3=名
4=z
5=6
6=6? 
7=工
8=4
9=3
之=设
来=经
得=诗
义=踏
各=正
州=场
化=水
口=改
解=名
必=必? 
兵=严
别=放
提=那
年=志
死=起
更=没
比=刺
百=明
做=爱
即=即? 
报=皇
直=境
非=什
未=弟
生=影
张=给
令=内
许=传
条=厨
变=拿
认=难
目=又
路=路? 
结=结? 
题=题? 
自=自? 
却=却? 
指=指? 
难=难? 
量=量? 
治=治? 
场=场? 
空=空? 
期=期? 
复=复? 
住=住? 
会=会? 
市=市? 
六=六? 
放=放? 
风=实
资=步
求=通
史=圣
色=孙
形=或
传=约
那=宣
领=状
清=继
决=击
笑=画
区=范
交=防
武=武? 
社=安
权=习
科=民
后=美
设=闻
李=李? 
改=改? 
字=月
故=怀
品=上
议=祖
花=领
七=乎
完=铵
能=家
林=部
据=种
院=之
远=最
收=近
众=解
车=冲
式=速
失=识
该=吧
所=所? 
连=连? 
近=是
格=更
干=福
怎=良
步=情
台=此
河=李
识=宋
拉=社
过=过? 
持=依
若=知
英=英? 
争=争? 
功=功? 
造=造? 
尽=尽? 
称=称? 
爱=形
导=史
中=刻
家=区
办=照
节=年
击=孩
商=绝
京=尽
虽=求
父=职
广=四
首=军
乎=精
十=髒
具=权
黄=炤
联=族
算=复
坐=坐? 
早=得
引=先
离=表
证=京
约=兔
发=球
母=父
组=英
房=来
精=罢
视=量
尚=投
断=牛
乃=般
影=调
除=察
然=众
青=青? 
初=初? 
守=答
县=县? 
质=应
语=变
越=指
举=续
皇=决
钱=立
作=山
历=最
乐=引
照=王
器=器? 
写=写? 
团=团? 
诸=诸? 
闻=闻? 
足=足? 
价=价? 
日=日? 
级=级? 
礼=礼? 
营=营? 
际=际? 
志=志? 
夜=夜? 
皆=皆? 
究=究? 
送=送? 
显=显? 
小=小? 
置=然
亚=包
包=馒
技=技? 
弟=弟? 
龙=龙? 
属=属? 
谓=谓? 
费=费? 
音=音? 
军=办
查=玉
专=和
止=音
找=级
食=风
装=赋
绝=商
答=海
敌=证
刘=险
二=等
依=瓣
按=即
久=争
宝=中
察=关
黑=士
投=毛
率=科
严=严? 
归=记
经=尚
玉=量
奇=纪
护=执
罪=十
吧=院
春=春? 
某=惊
拿=小
职=职? 
另=认
上=网
起=性
防=点
独=止
较=归
善=波
校=齐
围=奇
纪=交
族=秋
谁=意
惊=冒
与=条
底=鼎
孩=忘
供=自
姐=送
封=环
苦=效
刻=心
祖=初
宫=代
乱=青
好=所
效=食
般=结
段=段? 
福=供
宣=迫
采=营
态=功
续=令
境=历
米=找
学=梁
假=礼
试=封
状=特
诉=率
助=组
竟=盲
项=清
继=技
速=具
齐=外
种=式
低=助
退=退? 
田=谮
值=节
怀=县
景=干
执=色
型=把
毛=过
免=殿
分=收
略=理
药=敌
孙=早
兄=第
罢=型
劳=此
获=学
追=河
诗=住
充=能
此=春
适=百
圣=些
拜=校
雷=车
妇=今
胡=很
习=到
策=咳
败=败? 
宋=姐
心=获
富=治
尼=越
范=空
球=囗
秋=举
冲=苧
寻=写
良=米
股=力
险=普
前=称
波=劳
刺=就
谢=败
环=菩
面=前
们=据
又=又? 
没=故
知=儆
部=竟
些=些? 
理=离
明=却
样=必
意=较
月=算
到=际
正=目
实=处
把=际
但=特
两=价
民=民? 
力=皆
等=造
第=视
王=死
国=宫
情=制
它=们
手=似
四=顾
关=分
重=富
性=怎
点=吹
身=坐
至=会
和=國
物=充
战=Ⅻ
政=装
内=武
先=样
安=略
或=另
很=若
最=走
制=药
也=宝
美=费
山=项
什=乱
话=妇
名=量
合=化
水=未
常=常? 
产=产? 
立=策
就=物
代=代? 
走=走? 
言=言? 
处=处? 
通=通? 
特=特? 
给=给? 
海=海? 
今=今? 
表=表? 
